   ######################################################################################################################
               #           #     #        #     #  #  #        #     #  #              #  #        #        #     #     #
#  #  ####  #  ##########  #  ##########  #  ####  #  ####  #  ####  #  #  #######  #  #  #  #######  ####  #  #######  #
#  #  #     #           #  #     #        #     #  #        #              #        #        #  #        #     #        #
#  #######  ####  ####  #  ####  ####  #  ####  #  ####  ##########  #######  ####  ####  #  #  ####  #######  #######  #
#  #  #     #  #     #        #  #     #  #                       #  #           #  #     #     #           #        #  #
####  ####  #  ####  #  ####  #  #  ####  #######  #######  #  #######  #######  ####  #  #######  #######  #  ####  #  #
#     #  #     #     #  #     #     #  #     #     #        #  #     #        #  #  #  #  #     #  #     #  #     #  #  #
####  #  ##########  #  ####  #######  #  #  #  ####  ##########  #############  #  #######  ##########  ##########  #  #
#           #  #  #  #  #  #  #  #        #        #     #  #     #  #  #     #     #  #     #     #  #                 #
#  #  ####  #  #  #######  #  #  #  ####  #############  #  #  ####  #  #  #  #  ####  #  #  #  ####  #  #  #  #######  #
#  #     #     #     #     #     #  #     #     #                       #  #     #        #  #  #        #  #  #        #
#  #  #  ####  #  #######  #  ####  #  #  #  #  ####  ####  #  ##########  ####  #######  ####  ####  #############  ####
#  #  #     #     #  #  #        #  #  #     #     #  #  #  #        #  #  #  #  #     #           #  #                 #
####  #######  ####  #  ####  #############  #######  #  #############  ####  #######  #  #######  ####  ####  #######  #
#  #  #                 #  #     #        #  #                    #     #  #     #  #     #        #     #  #  #     #  #
#  ##########  ####  ####  ####  #  #  #  #  #######  #  #######  ####  #  #  #  #  #############  ####  #  ####  #  #  #
#        #  #     #  #     #  #     #  #  #     #  #  #  #  #        #     #  #        #                          #  #  #
####  #  #  #######  #  ####  #  ####  ####  ####  ####  #  ####  #  #  #######  ##########  ##########  #  #  ##########
#     #  #                 #        #     #  #     #        #     #     #     #        #     #  #        #  #  #     #  #
#  #  #  #  #  #  #######  #  ####  ##########  ####  #  #######  ####  ####  #######  #  ####  #  #############  ####  #
#  #  #     #  #  #  #        #        #     #  #     #     #     #     #  #     #        #        #           #  #  #  #
#######  #  #######  #######  #######  #  #  #  #  #  ################  #  #  ##########  ####  ##########  #  #  #  #  #
#        #     #        #        #  #     #  #  #  #        #     #                 #  #  #  #  #  #     #  #           #
#######  #  ####  ####  #  ####  #  #  #  ####  ####  ##########  ##########  ####  #  #  #  ####  #  #  #  #######  ####
#  #     #  #     #     #     #  #  #  #     #        #              #           #  #  #              #     #     #     #
#  #  #  #  #  #  #######  #######  #  #  ####  ####  ##########  #  #  #############  #######  #  #  #######  ####  ####
#  #  #  #     #     #  #           #  #  #     #  #  #           #        #           #     #  #  #        #     #  #  #
#  ####  ####  ####  #  #############  #  ####  #  #  #  ####  #############  #######  #  ####  #  #  ####  ####  #  #  #
#        #        #  #        #     #  #  #        #  #  #  #     #  #     #  #     #     #     #  #  #           #     #
#  ####  #  #######  #  ####  #  #  #############  #######  #  ####  #  ####  ####  #  #######  #  ##########  #######  #
#  #     #  #           #     #  #  #     #                 #  #              #     #           #  #           #        #
####  ################  #  ####  ####  ####  #  #  #  #######  #  #  #######  ####  #  #  ###################  #######  #
#     #     #           #        #           #  #  #        #     #  #     #  #  #     #  #  #     #  #        #        #
####  ####  #######  ####  ################  ####  #  ##########  #  #  #  ####  #  #  ####  #  ####  #######  ##########
#  #     #        #  #     #        #     #     #  #     #        #  #  #  #  #  #  #     #  #     #     #        #  #  #
#  #############  ####  #  #######  #  ####  ##########  ####  ####  ####  #  #  #  #######  ####  #  #  #  #######  #  #
#              #        #                    #        #     #  #        #                 #     #  #  #        #        #
####  ####  ##########  #######  ####  ####  #######  ###################  ################  ####  #  ####  ##########  #
#     #           #     #     #     #     #  #  #  #                 #     #           #     #     #  #     #           #
####  ####  ####  #  #  ####  ##########  ####  #  ##########  #######  #  ####  ####  ####  #  ####  ##########  ####  #
#     #  #  #     #  #  #              #  #  #     #  #              #  #           #     #     #  #     #     #  #     #
#######  #######  #  ##########  #  #  ####  ####  #  #  ##########  #  #############  #######  #  ####  #  ####  ####  #
#  #        #  #  #  #  #  #     #  #  #     #              #                 #     #  #              #  #  #  #     #  #
#  #  #  #  #  #  ####  #  ##########  ####  ####  #  ################  ####  #  ##########  #  #  #  #  #  #  #  #######
#     #  #        #  #     #           #        #  #     #  #        #     #  #              #  #  #     #  #  #     #  #
#######  #  #######  #  ####  #  ####  #  ##########  ####  #######  ################  ####  #######  #  #  #  #  ####  #
#  #  #  #        #  #     #  #  #  #     #        #  #  #        #        #  #     #  #     #  #  #  #                 #
#  #  #  #  ####  #  #  #######  #  ####  #  ##########  #  #  ####  #######  #  ####  #  ####  #  #  #######  #  #  #  #
#        #     #     #     #        #  #           #  #     #        #        #        #  #  #        #        #  #  #  #
#  ####  #  #######  #  #######  ####  #  #  #######  ####  #  #  #  ####  ####  #######  #  ##########  #  #############
#  #     #     #                    #     #           #     #  #  #        #     #     #        #        #  #        #  #
#  ####  #######  #############  ################  #######  #######  ####  ####  #  #  #  #######  ####  #  #  #  ####  #
#  #           #  #  #  #  #     #  #           #        #     #  #     #  #     #  #        #  #     #  #     #  #  #  #
####  #############  #  #  #  ####  ####  #  ####  ####  ####  #  #  ####  #  #  ####  #  #  #  ####  #  #  ####  #  #  #
#  #     #  #                             #  #  #  #     #  #     #     #     #  #  #  #  #     #     #  #     #  #     #
#  #  ####  #  ##########  #######  ####  ####  #######  #  ####  #  #############  ##########  #######  ##########  ####
#  #     #     #     #     #     #  #     #              #  #     #     #           #     #  #     #        #           #
#  #  ##########  ####  #  ####  #  ####  #######  #  #  #  ################  ##########  #  #  ####  ####  #  #  #######
#     #  #     #        #     #     #           #  #  #  #     #  #  #  #     #  #  #     #  #  #        #     #  #     #
#  ####  #  ##########  ####  #  #######  #  #  ####  ####  ####  #  #  #  ####  #  ####  #  ####  #  #  #######  ####  #
#     #        #  #     #     #  #     #  #  #  #     #     #  #     #     #  #        #  #        #  #  #     #        #
#  #######  ####  ####  #######  ####  ####  #  ##########  #  #  ####  ####  #  #  ####  ####  ##########  ####  #######
#        #           #        #           #  #  #  #     #  #     #           #  #     #  #  #  #     #        #        #
####  #######  ###################  ####  #  ####  #  ####  #  #  ##########  ####  ####  #  #######  #  #######  #######
#  #  #        #  #     #     #  #  #     #  #              #  #           #     #              #        #     #     #  #
#  #######  ####  #  #  ####  #  #  ##########  ####  #  ##########  #  ####  ####  #  #  #  ####  ####  ####  #  #  #  #
#        #           #  #                 #     #     #  #  #     #  #              #  #  #  #        #     #     #     #
####  #######  ####  ####  #######  #  ####  #############  #  #  ##########  #  #############  ####  ####  ####  #######
#  #  #  #  #     #        #     #  #  #  #           #     #  #              #     #  #           #  #              #  #
#  #  #  #  #  ####  ####  #  ####  ####  #  #  ####  ####  #######  ##########  ####  #  #  ################  #######  #
#           #     #     #  #                 #  #        #           #           #  #     #     #     #     #  #        #
#  ################  ####  ####  ###################  #  ####  #  ####  ##########  #############  #######  #  #  #  #  #
#        #     #     #     #              #           #        #     #     #     #  #  #     #     #        #     #  #  #
####  #  #  ####  #############  #  #  #  ###################  ####  #  ####  #  #  #  #  #  ####  #  #######  ####  ####
#  #  #  #  #  #     #     #  #  #  #  #        #  #  #        #     #  #  #  #        #  #           #        #  #     #
#  ####  #  #  ####  #  #  #  ####  #  #  #######  #  #  ####  #######  #  #  ####  ##########  #############  #  #  #  #
#           #  #  #     #     #     #  #           #        #        #  #        #  #     #     #        #     #     #  #
#  #######  #  #  #  #  ###################  ####  #######  #  #######  #  #  #######  ####  #######  #  #  ##########  #
#        #           #                    #     #     #     #     #        #                          #           #     
######################################################################################################################  
