   ######################################################################################################################
      #  #           #  #  #  #           #        #  #  #     #  #                    #  #     #                       #
####  #  #  ####  #  #  #  #  #  #  ####  #  ####  #  #  ####  #  #######  ####  #  ####  ####  ####  #  #############  #
#     #        #  #              #  #  #  #  #           #                 #     #  #           #     #           #     #
#  ####  ####  #############  ####  #  #######  ####  #######  #######  ####  ####  ####  #######  ####  ####  #  #  #  #
#        #        #           #     #  #        #        #        #  #     #  #           #        #     #     #  #  #  #
####  #  #  ####  ###################  ##########  #  #  #  #######  #  ####  #  ####  ######################  #######  #
#     #  #  #        #                 #  #     #  #  #  #     #           #  #  #        #                          #  #
#  #######  #  ####  #  #######  #######  #  ####  #######  ################  #  ####  ####  #  #  #  #  ####  ##########
#     #     #     #     #                             #  #        #     #  #  #     #        #  #  #  #  #     #        #
#  #  ################  #######  ####  #######  #######  #  ##########  #  #  ##########  #  ##########  #  #  #  #  ####
#  #              #     #  #  #  #  #  #  #        #     #     #        #        #     #  #  #     #     #  #     #     #
#  ####  #  #######  ####  #  ####  ####  ####  #######  #  ####  #######  ##########  ####  ####  #  #  ####  ##########
#     #  #     #        #  #  #     #     #     #        #  #     #           #     #              #  #  #        #     #
#  #  #  ################  #  #  #  #  #  ####  ####  #######  #######  ####  #  #######  #  #######  #  #############  #
#  #  #     #  #     #  #     #  #     #  #              #        #        #           #  #     #     #  #  #  #        #
####  #######  ####  #  #  #######  #  ####  #  #######  #  #  #  #  #  #  ##########  #  #  #######  ####  #  #  ####  #
#  #  #  #     #                    #  #     #     #     #  #  #     #  #  #  #     #  #  #        #  #     #     #  #  #
#  #  #  ####  #  #  #  #  ###################  #######  #######  ##########  #  ####  ####  ####  ####  #######  #  #  #
#  #  #     #     #  #  #              #              #     #     #  #     #  #     #  #        #              #  #     #
#  #######  #  #######  #######  #############  #  ####  #######  #  ####  #  ####  #######  ####  #  ####  #  #  ####  #
#  #  #     #  #  #           #     #           #  #     #                                #     #  #     #  #     #  #  #
#  #  ####  ####  ####  #############  #######  ####  #############  #######  ##########  #########################  ####
#  #  #           #        #  #              #     #  #     #        #  #        #  #        #  #  #  #  #     #  #     #
#  #  #  ####  #  #  ####  #  #  ######################  #  #  #  #  #  ##########  ##########  #  #  #  ####  #  #  ####
#  #  #  #     #     #                          #        #  #  #  #     #  #     #  #              #           #  #     #
#  #  ####  ####  ####  ####  ####  #  ################  ####  ####  ####  ####  #  #  #######  #  ####  #######  ####  #
#        #  #  #  #  #  #  #  #  #  #     #  #     #  #        #  #        #           #  #     #  #        #        #  #
#  #  #######  #  #  ####  #  #  #######  #  #  ####  #######  #  #  #######  ##########  ####  #######  ##########  #  #
#  #  #                 #        #     #  #  #  #     #     #  #        #  #  #     #        #  #  #  #  #              #
####  #  ####  #######  #  ##########  ####  #  #  #######  #  ####  ####  #  #  ####  #  ####  #  #  #  ####  #######  #
#        #     #        #     #           #     #        #     #     #     #  #  #  #  #     #        #        #  #     #
####  ######################  #  #############  #  #  #######  ####  #  ####  #  #  #  ##########  #  #  #######  ####  #
#     #  #           #           #  #        #     #     #  #     #           #  #                 #  #  #  #           #
####  #  #######  #  #  #######  #  #  ####  #######  #  #  #  #  ####  ####  #  ####  #######  ####  #  #  ####  #  #  #
#  #  #     #     #     #  #        #     #        #  #        #  #  #  #     #           #     #              #  #  #  #
#  #######  #  #  ####  #  ##########  ##########  #  ##########  #  ####  #######  #  ####  ###################  #  #  #
#        #     #  #                    #  #     #           #  #     #           #  #  #     #        #     #     #  #  #
#  ##########  ####  ####  #######  ####  ####  ##########  #  #  #  #######  ####  ##########  #######  #  #######  #  #
#  #              #     #  #  #           #           #        #  #  #  #        #  #  #           #  #  #     #  #  #  #
#  ####  ####  ####  ####  #  #  ####  #######  ####  #######  #  ####  #######  ####  ####  #  ####  #  #######  #######
#        #     #     #     #     #           #     #  #  #     #     #  #                    #     #  #        #        #
##########  ####  #######  ####  #  #  ####  #######  #  ####  #######  ##########  #  #######  ####  ####  #######  #  #
#        #  #           #  #     #  #  #           #  #        #  #                 #        #  #        #        #  #  #
#  #  ###################  ####  #  #  #############  ####  #  #  #  ####  #############  #  ##########  #  ####  #  ####
#  #  #              #     #  #  #  #     #        #        #  #        #     #  #        #        #        #  #  #     #
#  #############  #######  #  ####  ####  #  ##########  #  #  ####  #  #######  #  ####  #  ####  #  ####  #  #######  #
#           #  #  #     #     #     #  #     #  #        #  #  #     #        #     #     #     #     #     #  #  #  #  #
####  ####  #  #  #  #  #  ####  ####  #######  #######  #######  ##########  ####  #  ####  ####  ####  #  #  #  #  #  #
#     #  #     #     #        #  #  #              #     #  #           #  #  #  #  #     #  #  #     #  #  #           #
####  #  ####  ####  ####  ####  #  ####  #############  #  ####  #  ####  ####  #######  ####  #  ###################  #
#        #  #        #     #                       #        #  #  #              #           #     #     #  #           #
#  #  ####  #  #  ####  ####  #######  ####  ################  #  #  ##########  #######  ####  #  ####  #  ####  #  ####
#  #     #  #  #  #  #  #     #     #  #           #     #  #     #     #     #  #        #  #  #     #           #     #
#  #######  #  #  #  #######  #  #  #######  #  ####  #  #  ##########  ####  #  ##########  #######  #######  ##########
#     #        #  #        #     #     #     #     #  #     #           #                    #  #  #     #  #  #        #
#  ####  #  #  ####  #  #  ######################  ####  #  #  ####  #  #######  #  ##########  #  #  ####  #  #  #######
#  #  #  #  #  #     #  #  #              #        #     #     #     #        #  #     #           #  #  #        #  #  #
####  #######  ##########  #  #  ################  #######  #  #############  ####  #######  #  ####  #  #  #  ####  #  #
#  #     #           #     #  #     #           #     #     #        #  #        #  #        #           #  #  #        #
#  ####  #  ####  ####  #  #  ####  ####  #  #  ####  #######  ####  #  #  #  ################  #############  #  #######
#     #        #     #  #  #  #        #  #  #  #     #  #        #  #     #        #              #  #  #  #  #  #  #  #
#  #  #  #######  #  #  #############  #######  #  #  #  ####  ####  ####  #  ####  ####  ##########  #  #  #  #  #  #  #
#  #        #     #           #  #           #  #  #  #     #  #  #  #  #  #     #     #        #           #  #        #
#  #######  #  #############  #  #######  ####  ####  ####  ####  ####  ####  #  #######  #############  #  #  #  ####  #
#  #     #  #  #  #  #              #  #           #     #  #                 #  #              #        #  #     #     #
#  ####  #  ####  #  ####  #######  #  #  #  #  #  #######  ##########  ##########  #  ####  #  ####  #######  ####  ####
#  #           #     #     #              #  #  #  #  #     #              #        #     #  #        #        #     #  #
####  #  #  #######  ####  ##########  #############  #  #  #  #######  ####  #  #######  #  #  #  #  #  ##########  #  #
#     #  #     #  #        #     #        #  #  #  #  #  #  #  #  #        #  #        #  #  #  #  #  #  #  #     #     #
####  #  #######  ####  #######  #  #  #  #  #  #  #  #  #######  #############  ####  ####  #  ####  #  #  ####  ####  #
#     #     #     #     #        #  #  #  #        #  #           #  #     #        #  #  #  #  #              #  #     #
#  #  #######  #######  #  #  #######  ####  #  ####  #######  #  #  ####  #  #  #######  #  ####  #######  ####  ####  #
#  #     #  #        #     #  #     #     #  #  #        #     #     #        #     #  #        #        #     #        #
#  #  ####  #######  ####  ####  #  ##########  #  ##########  ####  #######  #######  #######  #  #  ####  #  #######  #
#  #        #           #  #  #  #     #     #  #              #  #        #  #     #  #        #  #  #  #  #     #  #  #
#  #  #  ####  #  #  #  #  #  #######  #  #  #  #  #  #  ####  #  ####  ####  #  ####  #  #######  #  #  #######  #  ####
#  #  #  #     #  #  #  #     #           #  #     #  #     #  #              #     #     #        #  #     #     #     #
#  #######  ####  #######  #  #  #  #  #############  #######  #######  ####  #  #  #######  ####  #  #  ####  ####  ####
#        #  #              #  #  #  #                    #           #  #        #        #  #     #  #                 
######################################################################################################################  
